..........................
..........................
............tttt..........
............t.sstttt......
tttt........t......t......
...st.......ttw....t......
.....t......tts.attttttttt
tt...tttttttt....attt.....
..t.....ssttt......ss.....
..t.................w...tt
...t...........tt...t..t..
...t..tt.......tt......t..
....t.....tt..........t...
.....t..tt..t......ttt....
......tt.....t...tt.......
..............ttt.........