..........................
............ttsatttttttt..
..........tts.t.....w..st.
.........ts........atd..t.
.......tts..tttdad.atdadtt
...tttss..t..ttd..........
tttss..........awwwwad....
t..tt.ad.......td.tt....tt
t.............tt..st....t.
tad....w.att...........t..
td..ad.t.att.......w...t..
t.t........s.......s..t...
.t......t.........t..t....
..t.ttt.......tt...tt.....
...t...ttttttt..ttt.......
..........................