..........................
............ttsatttttttt..
..........tts.t.f...w..st.
.........ts........atd..t.
.......tts..tttdad.atdadtt
...tttss..t..ttd.........1
tttss...f......awwwwad...1
t..tt.ad.......td.tt....tt
t....f.......ftt..st....t.
tad....w.att.f.........t..
td..ad.tfatt....f..w.f.t..
t.tff......s.......s..t...
.t..f...t.........tf.t....
..t.ttt.....f.tt...tt.....
...t...ttttttt..ttt.......
..........................